WWWW-O-WWW
WWWW------
WWWWWWWW-W
----------
WWWWWWWWW-
----------
WWWWWW-WWW
----------
WWWWW-WW-W
X---------